1111111111111111111111
10PC0000000000000001C1
1111111111111111110C01
1000000000000000000001
10C0001111111111111111
1000000000000000000101
1111111111100000111111
100C000000000000000001
1111111111111111100001
1E00000000000000000001
1111111111111111111111